1111111111111
10010P0C00001
10000111110P1
100011EP0CC11
1111111111111