1111111111111
10000P00E0001
1111111111111